                    111111111111111
                    1000000000000001
                    10000000000000001
         1111111111110000000000000001
         1000000000110000000000000001
         1011000001110000000000000001
         1001000000D0000000000000001
11111111101100000111000000000000001
1000000000110000011101111111D11111
111101111111110111000000100001
111101111111110111010110D0001
11000000110101011101100110001
10000000000000001100000010001
10000000000000001111010010001
1100000111010101 10001111000111
11110111 1110101 1011110100N1
11111111 11111011101111111111
             1000001
              11111