         111111111111111111111111111
         1000000000110000000000000001
         1011000001110000000000000001
         100100000000000000000000001
11111111101100000111000000000000001
1000000000110000011101111111011111
111101111111110111000000100001
11110111111111011101011000001
11000000110101011101100110001
10000000000000001100000010001
10000000000000001111010010001
1100000111010101 100011110N0111
11110111 1110101 101111010001
11111111 11111011101111111111
             1000001
              11111