11111111111111111
100000000000000001
1100000S000000001
10000000110000001
100000000000000001
100000000000001001
100000000000010001
100000000000001001
100000000000000001
100000000000000001
10000010000000001
11111111111111111