111111111111111111111111111111111
1E000000000000000110000000000001
1000000000000000000000000000001
10000000000000000110000000000001
10000000000000000000000000000001
111111111011000001110000000000001
        1001000000000000000000001
111111111011000001110000000000001
100000000011000001110111111111111
11110111111101011100000010001
11110111110110011101010010001
11000000110101011100000010001
1000000000000001100000010001
10000000000010001101010000001
110000111101010111110111100111
110101    10101 100001010001
110111111111111  101111110111
11011000000001   1001    1
11001011111101111100111111111
11100011 11100000000111111111
11111111 11111111111111111111
