NO ./Bonus/images/textures/north_1024.png
SO ./Bonus/images/textures/south_1024.png
WE ./Bonus/images/textures/west_1024.png


EA ./Bonus/images/textures/east_1024.png
F     165, 157, 132
C    212, 235, 248
                    111111111111111
                    1000000000000001
                    10000000000000001
         1111111111110000000000000001
         1000000000110000000000000001
         1011000001110000000000000001
         100100000000000000000000001
11111111101100000111000000000000001
1000000000110000011101111111011111
111101111111110111000000100001
11110111111111011101011000001
11000000110101011101100110001
10000000000000001100000010001
10000000000000001111010010001
1100000111010101 10001111000111
11110111 1110101 1011110100N1
11111111 11111011101111111111
             1000001
              11111