NO ./images/textures/north200.png
SO ./images/textures/south200.png
WE ./images/textures/west200.png


EA ./images/textures/east200.png
F      255 ,220,   255 
C    11, 25, 44



        1111111111111111111111111
        1000000000110000000000001
        1011000001110000000000001
        1001000000000000000000001
111111111011000001110000000000001
10000000001100000111011111D111111
11110111111111011100000010001
11110111111111011101010010001
11000000110101011100000010001
10000001100000001100000010001
1000001  10000001100000010001
1000001  10000001101010010001
10000001100000001101010010D01
11000001110101011111011110N0111
11110111 1110101 101111010001
11111111 1111111 111111111111